S..........................#................................
.#########################.#.##############################.
.#.........................#.#............................#.
.#.#########################.#.##########################.#.
.#.#.......................#.#.#........................#.#.
.#.#.#####################.#.#.#.######################.#.#.
.#.#.#...................#.#.#.#.#....................#.#.#.
.#.#.#.#################.#.#.#.#.#.##################.#.#.#.
.#.#.#.#...............#.#.#.#.#.#.#................#.#.#.#.
.#.#.#.#.#############.#.#.#.#.#.#.#.##############.#.#.#.#.
.#.#.#.#.#...........#.#.#.#.#.#.#.#.#............#.#.#.#.#.
.#.#.#.#.#.#########.#.#.#.#.#.#.#.#.#.##########.#.#.#.#.#.
.#.#.#.#.#.#.........#.#.#.#.#.#.#.#.#.#........#.#.#.#.#.#.
.#.#.#.#.#.#.#####.#.#.#.#.#.#.#.#.#.#.#.######.#.#.#.#.#.#.
.#.#.#.#.#.#.#...#.#.#.#.#.#.#.#.#.#.#.#.#....#.#.#.#.#.#.#.
.#.#.#.#.#.#.#.G.#.#.#.#.#.#.#.#.#.#.#.#.#....#.#.#.#.#.#.#.
.#.#.#.#.#.#.#.....#.#.#.#.#.#.#.#.#.#.#.#....#.#.#.#.#.#.#.
.#.#.#.#.#.#.#####.#.#.#.#.#.#.#.#.#.#.#.######.#.#.#.#.#.#.
.#.#.#.#.#.#.......#.#.#.#.#.#.#.#.#.#.#........#.#.#.#.#.#.
.#.#.#.#...#########.#.#.#.#.#.#.#.#.#.##########.#.#.#.#.#.
.#.#.#.#.#...........#.#.#.#.#.#.#.#.#............#.#.#.#.#.
.#.#.#.#.#############.#.#.#.#.#.#.#.##############.#.#.#.#.
.#.#.#.................#.#.#.#.#.#.#................#.#.#.#.
.#.#.#.#################.#.#.#.#.#.##################.#.#.#.
.#.#.....................#.#.#.#.#....................#.#.#.
.#.#.#####################.#.#.#.######################.#.#.
.#.........................#.#.#........................#.#.
.#.#########################.#.##########################.#.
.#........................................................#.
.##########################################################.