S..........................#................................
.#########################.#.##############################.
.#.........................#.#............................#.
.#.####.####################.#.##########################.#.
.#.#.......................#.#.#........................#.#.
.#.#.#####################.#.#.#.######################.#.#.
.#.#.#...................#.#.#.#.#....................#.#.#.
.#.#.#.#####.###########.#.#.#.#.#.##################.#.#.#.
.#.#.#.#...............#.#.#.#.#.#.#................#.#.#.#.
.#.#.#.#.##########.##.#.#.#.#.#.#.#.##############.#.#.#.#.
.#.#.#.#.#...........#.#.#.#.#.#.#.#.#............#.#.#.#.#.
.#.#.#.#.#.#########.#.#.#.#.#.#.#.#.#.##########.#.#.#.#.#.
.#.#.#.#.#.#.........#.#.#.#.#.#.#.#.#.#........#.#.#.#.#.#.
.#.#.#.#.#.#.#####.#.#.#.#.#.#.#.#.#.#.#.######.#.#.#.#.#.#.
.#.#.#.#.#.#.#...#.#.#.#.#.#.#.#.#.#.#.#.#....#.#.#.#.#.#.#.
.#.#.#.#.#.#.#.G.#.#.#.#.#.#.#.#.#.#.#.#.#....#.#.#.#.#.#.#.
.#.#.#.#.#.#.#.....#.#.#.#.#.#.#.#.#.#.#.#....#.#.#.#.#.#.#.
.#...#.#.#.#.#####.#.#.#.#.#.#.#.#.#.#.#.######.#.#.#.#.#.#.
.#.#.#.#.#.#.......#.#.#.#.#.#.#.#.#.#.#........#.#.#.#.#.#.
.#.#.#.#...#########.#.#.#.#.#.#.#.#.#.##########.#.#.#.#.#.
.#.#.#.#.#...........#.#.#.#.#.#.#.#.#............#.#.#.#.#.
.#.#.#.#.#############.#.#.#.#.#.#.#.##############.#.#.#.#.
.#.#.#.................#.#.#.#.#.#.#................#.#.#.#.
.#.#.#.#####.###########.#.#.#.#.#.##################.#.#.#.
.#.#.....................#.#.#.#.#....................#.#.#.
.#.#.#####################.#.#.#.######################.#.#.
.#.........................#.#.#........................#.#.
.#.##############.##########.#.##########################.#.
.#........................................................#.
.##########################################################.