S...........#..##..#....###...
.#..#..##..####..#..#..##.....
.#..#...#..#....##..#.#..#....
....#.#.#..####.#..#..#.#.....
.####.#.#..#....#..####.#..#..
......#.#..##..#..#....##.....
.######.#..####.#..##.#..#....
........#..#..#....#..##.#....
.########..####..#..####..#...
........#.......#...#....#....
..##..####..#..#..####..#..#..
.#..#....#..##..#..#..####....
.#..####.#..#....#..##..#.....
....#..#.#..####..#..#.#..#...
.####..#.#..#....##..####..#..
......#..##..#..#....#..##....
.######..####.#..##..#..#.....
............#..#..#..##.#..#..
.########..####..#..####..#...
....#....#..##..#....#..#.....
..##..####..#..#..####..#..#..
.#..#....#..##..#..#..####....
.#..####.#..#....#..##..#.....
....#..#.#..####..#..#.#..#...
.####..#.#..#....##..####..#..
......#..##..#..#....#..##....
.######..####.#..##..#..#.....
........#..#..#....#.....#....
.########..####..#..####..#...
....................#........G