S.......#...............................
.######.#.#############################.
.#......#.#...........................#.
.#.######.#.#########################.#.
.#.#................................#.#.
.#.#.##############################.#.#.
.#.#.#............................#.#.#.
.#.#.#.##########################.#.#.#.
.#.#.#.#........................#.#.#.G.
.#.#.#.##########################.#.#.#.
.#.#.#............................#.#.#.
.#.#.##############################.#.#.
.#.#................................#.#.
.#.##################################.#.
.#....................................#.