S.......#...............................
.######...#############################.
........#.#...........................#.
.#.######.#.#########################.#.
.#.#................................#.#.
.#.#.##############################.#.#.
.#.#.#............................#.#.#.
.#.#.#.##########################.#.#.#.
.#.#.#.#........................G.#.#.#.
.#.#.#.##########################.#.#.#.
.#.#.#............................#.#.#.
.#.#.##############################.#.#.
.#.#................................#.#.
.#.##################################.#.
.#....................................#.