S...#.....
.#..#..##.
.#..#...#.
....#.#.#.
.####.#.#.
......#.#.
.######.#.
........#.
.########.
........G.